############
#*.........#
#..........#
#..........#
#..........#
#..........#
#..........#
#..........#
#.....gg...#
############