############     
#*.........#
#..........#
#....#.....#
#....#...g.#
#....#.....#
#....#...s.#
#..G.......#
#........g.#
############