############     
#*.........#
#..........#
#..........#
#......h...#
#.........##
#.......#..#
#..G...#...#
#....#.....#
############