##########
#........#
#........#
#........#
#........#
#....*...#
#........#
#........#
#........#
##########