############     
#*.........#
#.......G..#
#..........#
#.....h....#
#..#.......#
#......##..#
#.g........#
#........s.#
############