############     
#*.........#
#..........#
#..........#
#......h...#
#..........#
#..........#
#..w.......#
#..........#
############