############     
#*.........#
#.......G..#
#..........#
#.....h....#
#..........#
#......##..#
#.w........#
#..........#
############