############     
#*.........#
#..........#
#...####...#
#...#......#
#...#...g..#
#..........#
#..G.......#
#.......g..#
############