############
#*.........#
#..........#
#..........#
#..........#
#..........#
#..........#
#..........#
#........g.#
############