############     
#*.........#
#.......GG.#
#..........#
#.......ss.#
#..........#
#......##..#
#.gg.......#
#.....w...w#
############