############     
#*.........#
#.......G..#
#..........#
#.....h....#
#..........#
#......##..#
#.g........#
#......w...#
############