############     
#*.........#
#........s.#
##.........#
##.####....#
##......s..#
#..........#
#..g.......#
#.......g..#
############