############     
#*.........#
#.......G..#
#..........#
#..........#
#..........#
#......##..#
#.g........#
#.....w...w#
############