############     
#*.........#
#..........#
#..........#
#..........#
#..........#
#..........#
#.g..w....s#
#..........#
############