############     
#*...#...#.#
#..........#
#.#..###.#.#
#....#.#...#
#..#####..##
#.......#..#
#..G...#...#
#....#.....#
############