############     
#*.........#
#..........#
#..........#
#..........#
#..........#
#....g.....#
#..........#
#..........#
############