############     
#*...#...#.#
#..........#
#.#..###.#.#
#......h...#
#.........##
#.......#..#
#..G...#...#
#....#.....#
############