############     
#*.........#
#..........#
#....#.....#
#....#.....#
#....#..s..#
#....#.....#
#..g.......#
#..........#
############