############     
#*.........#
#.......#..#
#......#...#
#.....#....#
#....#.....#
#..........#
#.g....g...#
#..........#
############