############     
#*.........#
#....h..GG.#
#..........#
#.......ss.#
#..........#
#......##..#
#.gg.......#
#.h...w...w#
############