############     
#*.........#
#..........#
#..#####...#
#..........#
#.......s..#
#.....h....#
#..g...g...#
#..........#
############