############     
#*.........#
#..........#
#..........#
#....#.....#
#....#.....#
#....#..s..#
#..........#
#..........#
############