############     
#*.........#
#..........#
#..........#
#..........#
#..........#
#......##..#
#.g........#
#..........#
############